11111111111111111
110CCC0000CCC00N1
1P010000011100001
1111001111C000001
10000CCCC1C0000N1
1000011111C00NC01
110000000000NC0E1
11111111111111111